NO      ./textures/1.xpm
SO   ./textures/2.xpm
WE      ./textures/3.xpm
EA    ./textures/4.xpm

F  122,122,122
C  122,122,122

11111111111111111111111111111111111111111111111111111111111111111
11111000000000000100100000100000000000000000000000000000000000001
11111000000000000100111110100000000000000000000000000000000000001
10000000000000000100100000100000000000000000000000000000000000001
11111111111111111110010000010000000000000000000000000000000000001
10001000010001111100111111111110000000000000000000000000000000001
10001000010000000000000000000010000000000000000000000000000000001
10001000010000000000000000000010000000000000000000000000000000001
10001000010001111011111111000011111110000000000000000000001111111
10001000010001001010000001000000000000000000000000000000000000001
10001000010001001011111111000010000010000000000000000000001000001
10001111110001001000000000000010010010011111111111111111001001001
10000000000001001111101111000010010010000000000000000000001001001
10000000000001000000101111000010010011111111111111111111111001001
10000000000001000000100000000010010000000000000000000000000001001
10000000000001000000100000000010011111111111111111111111111111001
10111111111111000000111111111110000000000000000000000000000000001
10000000100000000000100000000011111111111111111111111111111111101
11111100111111111111100000000010000000000000000000000000000000101
10000000100010000000000000000111000000000000000000000000000000101
10000000000000000000000000000101000000000000000000000000000000101
11111111110000000001111111111101111111111111111111111111111111101111111
11111111110000000001111111111100000000000000000000000000000000000000001
11111111110000000001111111111101111111111111111100000000000000000000001
11111111110000000001111111111101111111111110000000000000000011110000001
11111111110000000001111111111101111111111110000000000000000010010000001
11111111110000000001111111111101000000000000011000000000000010010000001
11000000000111100000000011111101000000000000011000001111111110010000001
1100000000011110000000001111110100000E000000011111111111111110011111111
11000000000111100000000011111101001111111111111111111111111111111111111
11000000000111100000000011111101000000000000000000000000000000000000001
11101111111101111111100000000001010001000100010001000100010001000100101
11101111111111111111111111111111000100010001000100010001000100010001001
10101000000000000100000000000010010001000100010001000100010001000100011
10101111110111110101111111101111000100010001000100010001000100010001001
10101000000101000001000000000010010001000100010001000100010001000100011
10101011111101011101011111111111000100010001000100010001000100010001001
10101000000000010101000000000000010001000100010001000100010001000100011
10000011111111110101011111111111000100010001000100010001000100010001001
10101000001000010101000000000010010001000100010001000100010001000100011
10111111111111010101111111111111000100010001000100010001000100010001001
10000001000000000000000000000010010001000100010001000100010001000100011
11111111111111111111111111111111111111111111111111111111111111111111111
