NO ./textures/1.xpm
SO ./textures/2.xpm
WE ./textures/3.xpm
EA ./textures/4.xpm

F 12,122,150
C 122,240,200

11111111111111111111
10000000000000000001
10000000000000000001
10000000000000000001
100000000W0000000001
10000000000000000001
10000000000000000001
11111111111111111111