NO ./textures/1.xpm
SO ./textures/2.xpm
WE ./textures/3.xpm
EA ./textures/4.xpm

F 122 ,  122 , 122
C 123     ,  122 , 122

11111111111111
1000001
100N00111
1111111
