NO ./textures/1.xpm
SO ./textures/2.xpm
WE ./textures/3.xpm
EA ./textures/4.xpm

F  122,122,122
C  122,122,122

1111111111111111111111111111111111111111
1000000000000000000000000000000000000001
1000000001000000000000000000000000000001
1000000000000000000000000000000000000001
1000000000000000000000000000000000000001
100000000000000000E000000000000000000001
1000000000000000000000000000000001000001
1000000001000000000000000000000001000001
1000000001000000000000000000000001000001
1000000000000000000000000000000001000001
1000000000000000000000000000000001000001
1111111111111111111111111111111111111111